1111111
11CE001
111C0P1
1111111