1111111
110E001
111C0P1
1111111
