1111111111111
10011100E0C01
1000000111001
1000110000001
1000000111001
1000110000001
1000000101001
10001100P0001
1111111111111
1111111111111
1111111111111
1111111111111

