1111111111111
10011100E0C01
1000000111001
1000110P00001
1111111111111
        1
